XXXXXXXXXXXXXXXXXXXXX
XJXOXOXOOOOIOOOOOOXIX
XOXOXIXXXOXXXOXXXXXOX
XOOOOOXOIOXOOOXOOOOOX
XOXXXXXXXOXOXOXOXXXOX
XOOIOOXIOOXOXIXOXOOOX
XOXOXOXOXOXOXXXOXXXIX
XIXOXOXIXOXOOIOOOOXOX
XOXXXXXOXXXXXXXOXXXXX
XOOOXIXOOOXOOOOOOOIOX
XOXOXOXOXOXXXOXXXXXOX
XOXOOOOOXOIOXOXIOOOOX
XOXXXXXXXXXXXXXOXXXOX
XOIOXOXOOOOOOIXOXOOOX
XXXXXOXXXOXOXXXXXOXOX
XIXOXOOOOOXOOOOOXIXOX
XOXOXXXOXOXXXXXXXOXOX
XOOIXIOOXOOOOIXIXOXOX
XOXXXXXOXXXXXXXOXOXXX
XOOOOOOOOOOOOOOOOOIOX
XXXXXXXXXXXXXXXXXXXXX