XXXXXXXXXXXXXXXXXXXXXXXX
XOOOOOOOOOOOOOOOOOOOOOOX
XOOOOOOOOOOOOOOOOOXOOOOI
XOOOOOOOOOOOOOOOOOXOOOOX
XOOOOOOOOOOOOOOOOOXOOOOX
XOOOOOOOOOOOOOOOOOOOOOOX
XOOOOOOOOOOOOOOOOOOOOOOX
XXXXXXXXXXXXXXXXXXXXXXXX